        1111111111111111111111111
        110000000110000000000001
        1111000001110000000000001
        111111000000000000000001
111111111111000001110000000000001
111111111111000001110111111111111
11110111111111011100000010001
11110111111111011101010010001
11000000110101011100000010001
10000000000111111100000010001
10000000100000001101010010001
1100000110101011111011110N0111
11111111 1110101 101111010001
11111111 1111111 111111111111
11111100011111110001111111111
11111111111111111111111111111