NO ./texture/wood0.xpm
SO ./texture/wood1.xpm
WE ./texture/wood2.xpm
EA ./texture/wood3.xpm

F 85,31,18
C 52,158,220

        1111111111111111111111111
        100000000110000000000001
        100011110000000001000001
        100000000000011N00000001
111111111011000001110000000000001
10000000000000001110000111111111
1111001111111011100000010001
11110011111110011101010010001
11000000111110011100000010001
1000000001111111100000010001
10001000000000001100000000001
110000011101010111110111100111
11110111 1110101 101111010001
11110111 1010101 101111010001
10110111 1111111 1111000111111
10111111 1101011 110011111111111
11111111 1111111 111111111111