NO ./texture/pic0.xpm
SO ./texture/pic1.xpm
WE ./texture/pic2.xpm
EA ./texture/pic3.xpm

F 61,41,28
C 53,168,230

11111111111111111111111111111111111111
11111111111111111111111111111111111111
11111111100111111111111111111111111111
11111111101111111111111111111111111111
11111111100001111110111111111111111111
11111111111001111100011111111111111111
11111111111001111000001111111111111111
111110000000000N0000000000000000000001
11111000000000000000000111111111000001
11111111011111111111111111111111111111
11111111011111111111111111111111111111
11111111011111111111111111111111111111
11111000000000000000000000111111111111
11111000000000000000000000111111111111
11111111111111110001111111111111111111
11111111111111111111111111111111111111
