NO ./texture/pic0.xpm
SO ./texture/pic1.xpm
WE ./texture/pic2.xpm
EA ./texture/pic3.xpm

F 61,41,28
C 53,168,230

        11111111111111111111111111
        1000000001100000000000011
        1000111100000000010000011
        100000000000011000000001111
111111111011000001110000000000001
100000000000000011100001111111111
111100111111101110000001000111
1111001111111001110101001000111
110000001111100111000000100011
100000000111111110000001000111
1000N0000000000011000000000011
1100000111010101111101111001111
111111111111111111111111111111
11111 1111 11111 1111  11111111
